111111111111
100000000001
101103330001
122003330001
100000011001
100022011001
100022000001
100000000001
100000000001
100000000001
100000000001
111111111111