1111111111111111111111111111111111
2000000000000000000000000000000002
2000000000000000000000000000000002
2000000000000000000000000000000002
2000000000000000000000000000000002
2000000000000000000000000000000002
2000000000000000000000000000000002
2000000001230000000000000000000002
2000000003210000000000000000000002
2000000000000000000000000000000002
2000000000000000000000000000000002
2000000000000000000000000000000002
2000000000000000000000000000000002
2000000000000000000000000000000002
2000000000000000000001230000000002
2000000000000000000003210000000002
2000000000000000000000000000000002
2000000000000000000000000000000002
2000000000000000000000000000000002
2000000000000000000000000000000002
2000000000000000000000000000000002
2000000000000000000000000000000002
2000000000000000000000000000000002
1111111111111111111111111111111111