111111111111
200000000001
300230000001
100320000001
200000011001
300022011001
100022000001
200000000001
300000000001
100000000001
200000000001
312312311111